10 10
1 1 1 1 1 1 1 1 1 1
1 4 0 0 0 1 1 0 0 1
1 0 16 0 0 0 1 1 1 1
1 0 0 64 0 1 0 0 0 1
1 1 0 0 0 1 0 16 0 1
1 1 0 0 0 0 0 64 0 1
1 1 0 0 64 0 0 0 0 1
1 1 1 0 0 16 0 0 0 1
1 0 0 0 0 1 1 0 0 2
1 1 1 1 1 1 1 1 1 1